#####################
#.........#.........#
#@##.####.#.####.##@#
#.##.####.#.####.##.#
#...................#
#.##.#.#######.#.##.#
#....#....#....#....#
####.####.#.####.####
   #.#.........#.#   
####.#.### ###.#.####
.......#gghgg#.......
####.#.#######.#.####
   #.#....p....#.#   
####.#.#######.#.####
#.........#.........#
#.##.####.#.####.##.#
#@.#.............#.@#
##.#.#.#######.#.#.##
#....#....#....#....#
#.#######.#.#######.#
#...................#
#####################